22
13
13
      ############    
      #  I  ##   #    
      # #I     P #    
 ###### ##III# ####   
##  ##III####     ####
# C ##III    C #  C  #
#     II ## # ## ##  #
####C###C# C  #   # ##
 ###  #    ##C CC # # 
 #   CC # # C # C## # 
 #                  # 
 #################  # 
                 #### 
