17
18
15
          #######
          #  III#
      #####  III#
      #      III#
      #  ##  III#
      ## ##  III#
     ### ########
     # CCC ##    
 #####  C C #####
##   #C C   #   #
#P C  C    C  C #
###### CC C #####
     # C    #    
     #### ###    
        #  #     
        #  #     
        #  #     
        ####     
