22
15
24
 #####################
##                   #
#    C #      ## #   #
#  ###### ###  #C## ##
##C#   ##C#IIII   # # 
#  #    C #IIII## # # 
# C # # # #IIII##   # 
# C #CC   #IIII##C# # 
# # CPC##C#IIII##   # 
#   CCC   #IIII#    # 
#  C#   # ###### C### 
##  # ###CC  C   C #  
##     # C  C ##   #  
 #####   #   #######  
     #########        
