23
20
22
 ##################### 
 #   ##  #   #   #   # 
 # C     C   C   C   ##
##### #  #   ### ##C###
#   # ##C######   #   #
# C   # IIIIII#   # C #
## #  # IIIIII#####   #
## #########II#   # ###
#          #II# C   #  
# ## ### ###II## #  ###
# #   #   ##II## ###  #
#   P      CII#       #
# #   #   ##  #   ##  #
##### ############## ##
#          #   #    C #
# C  # C C C   # #    #
# #C## C#  ## ##    # #
#  C CC #### C  C # # #
#          #   #      #
#######################
