17
16
16
    ############ 
    #          ##
    #  # #CC C  #
    #C #C#  ## P#
   ## ## # C # ##
   #   C #C  # # 
   #   # C   # # 
   ## C C   ## # 
   #  #  ##  C # 
   #    ## CC# # 
######CC   #   # 
#IIII#  ######## 
#I#III ##        
#IIII   #        
#IIII   #        
#########        
