21
16
24
     #############   
     #    ###    #   
     #     C C  #### 
   #### #   C C    # 
  ## C  #C#### C C # 
###   # #   ###  C # 
# C  C  #  C  # #### 
# ##C#### #C#  C  ###
# ##  ### # # #  C  #
#    PC   C   # C # #
#####  #  ##  # C#  #
  #III #####C  #  # #
  #IIIIIII# CC #C # #
  #IIIIIII#         #
  #IIIIIII#######  ##
  #########     #### 
