23
13
20
 #################     
 #III   #    #   ###   
##IIIII  C## # # C #   
#IIIIII#  C  #  C  #   
#IIIIII#  #  # # # ##  
######### C  C # #  ###
  #     #C##C ## ##   #
 ##   C    # C  C   # #
 #  ## ### #  #####C# #
 # C CC     C   C     #
 # C    C##C ######## #
 #######  P ##      ###
       ######          
