12
15
15
############
##     ##  #
##   C   C #
#### ## CC #
#   C #    #
# CCC # ####
#   # # C ##
#  #  #  C #
# C# C#    #
#   II# ####
####II C #P#
#IIIII# C# #
##IIII#  C #
###II##    #
############
