20
15
16
           #####    
          ##   ##   
         ##     #   
        ##  CC  #   
       ## CC  C #   
       # C    C #   
####   #   CC ##### 
#  ######## ##    # 
#II           CCCP# 
#I# ####### ##   ## 
#I# #######I #C C###
#IIIIIIIIIII #   C #
##############  C  #
             ##  ###
              ####  
