14
10
10
############  
#II  #     ###
#II  # C  C  #
#II  #C####  #
#II    P ##  #
#II  # #  C ##
###### ##C C #
  # C  C C C #
  #    #     #
  ############
