24
11
16
                #####   
       ###### ###   ####
   #####    ### C C  C #
####  ## #C C    C #   #
#IIII   CC C C  C   #C##
#II # ## #   ###C## #  #
#IIII    # ###    #    #
#IIII    # ##  C  ###C #
#II######  C  #  #### ##
####    #   ###    P  # 
        ############### 
