17
17
15
       ####      
    ####  #      
   ##  #  #      
   #  C C #      
 ### #C   ####   
 #  C  ##C   #   
 #  # P C # C#   
 #  #      C ####
 ## ####C##     #
 # C#IIIII# #   #
 #  CIIIBI C# ###
##  #IIIII#   #  
#   ### #######  
# CC  #  #       
#  #     #       
######   #       
     #####       
