17
13
15
################ 
#              # 
# # ######     # 
# #  C C C C#  # 
# #   CPC   ## ##
# # #C C C###III#
# #   C C  ##III#
# ###CCC C ##III#
#     # ## ##III#
#####   ## ##III#
    #####     ###
        #     #  
        #######  
