21
14
16
 ####                
##  #####            
#       # #####      
# C###  ###   #      
#II#  C# #  # #      
#II#      CC# ###    
#IB# #  #C C    #####
#II#  ##     ##C#   #
#IBC  C # ##  C     #
#II##  C   #   ######
#IB##C##   #####     
#II  C #####         
#  # P #             
########             
