21
20
34
              ####   
         ######  #   
         #       #   
         #  #### ### 
 ###  ##### ###    # 
##P####   CCC #    # 
# CC   CC C   #IIII##
#  CCC#    C  #IIIII#
# C   # CC CC #IIIII#
###   #  C    #IIIII#
  #   # C C C #IIIII#
  # ####### ###IIIII#
  #   #  C C  #IIIII#
  ### # CC C C#######
    # #  C      #    
    # # CCC CCC #    
    # #       # #    
    # ######### #    
    #           #    
    #############    
