16
15
12
       ####     
       #  ##    
       #   ##   
       # CC ##  
     ###C  C ## 
  ####    C   # 
###  # #####  # 
#    # #IIIIC # 
# #   C IIII# # 
#  C # #IBII# # 
###  #### ### # 
  #### PC  ##C##
     ### C     #
       #  ##   #
       #########
