13
19
16
   ##########
   #  ###   #
   # C   C  #
   #  ####C##
   ## #  #  #
  ##  #IB   #
  #  ##II#  #
  # P #IB# ##
  # #C#II#C #
  # C #II#  #
  # # #BB#  #
  # C #II#C##
  #    IB#  #
 ###  #  #  #
##    ####  #
#  #######C##
# C      C  #
#  ##   #   #
#############
