11
11
8
      #### 
####### P# 
#     C  # 
#   C## C# 
##C#III# # 
 # CIII  # 
 # #I I# ##
 #   # #C #
 #C  C    #
 #  #######
 ####      
