14
15
14
 #########    
 #IIII   ##   
 #I#I#  C ##  
##IIII# # P## 
# IIII#  #  ##
#     #C ##C #
## ###  C    #
 #C  C C C#  #
 # #  C C ## #
 #  ###  ##  #
 #    ## ## ##
 #  C #  C  # 
 ###C C   ### 
   #  #####   
   ####       
