18
19
21
     ####         
   ###  ##        
####  C  #        
#   C C  ####     
# C   # C   # ####
#  #  #   C # #II#
##C#C ####C####II#
 #   ##### ## III#
 #C# ##P## ##  II#
 # #    C     III#
 #   #### ###  II#
 ### ## #  ## III#
  ##C ####C ###II#
  #   ##    # #II#
 ## CC##  C # ####
 #     CCCC #     
 # C ###    #     
 #   # ######     
 #####            
