22
20
35
            ####      
 ############  #####  
 #    #  #  C  #   ## 
 # C C C  C # C C   # 
 ##C C   # P# C   C # 
###   ############ ## 
#  C C#  #IIIIII# C#  
# #   #  #IIIIII## #  
#  ## ## # IIIII#  #  
# #      CIIIIII C #  
# # C ## #IIIIII#  #  
#  C C#  #IIIIII# C#  
# C   #  ##C#####  #  
# C C #### C C  C C#  
## #     C C C C   ###
 #  ###### C    C    #
 #         # ####### #
 ####### #C          #
       #   ###########
       #####          
