18
11
16
         ####     
 #########  ##    
##  C      C #####
#   ## ##   ##III#
# #CC C CC#C##III#
# #    P  #   III#
#  C# ###CC   III#
# C  CC  C ##IIII#
###C       #######
  #  #######      
  ####            
