19
15
9
 #####             
 #   #             
 # # ######        
 #      CP######   
 # C ##C ###   #   
 # #### C    C #   
 # ##### #  #C ####
##  #### ##C      #
#  C#  C  # ## ## #
#         # #III# #
######  ###  III  #
     #### # #III# #
          # ### # #
          #       #
          #########
