19
15
14
          ####     
     #### #  #     
   ###  ###C #     
  ##   P  C  #     
 ##  C CC## ##     
 #  #C##     #     
 # # C CC # ###    
 #   C #  # C #####
####    #  CC #   #
#### ## C         #
#I    ###  ########
#II II# ####       
#III#I#            
#IIIII#            
#######            
