12
11
10
######  ### 
#II  # ##P##
#II  ###   #
#II     CC #
#II  # # C #
#II### # C #
#### C #C  #
   #  C# C #
   # C  C  #
   #  ##   #
   #########
