25
14
18
       #######           
       #  #  ####        
       # C#C #  ##       
########  #  #   ########
#IIII  # C#C #  C#  #   #
#IIII# #     #C  #      #
#II#I    C#  # C    #C  #
#III P##  #C #C  #  #   #
#IIII ## C#     C########
########  #CC#C  #       
       # C#  #  C#       
       #  #  #   #       
       ####  #####       
          ####           
