13
15
15
      ####   
  #####  #   
 ##     C#   
## C  ## ### 
#PC C # C  # 
#### ##   C# 
 #IIII#C C # 
 #IIII#   C# 
 #IIII  CC ##
 #III # C   #
 ######C C  #
      #   ###
      #C ### 
      #  #   
      ####   
