19
11
9
        #######    
    #####  #  #### 
    #   #   C    # 
 #### #CC ## ##  # 
##      # #  ## ###
#  ### C#C  C  C  #
#III    # ##  #   #
#III#    P # ### ##
#III#  ###  C  C  #
######## ##   #   #
          #########
