23
18
25
              ###      
             ##I###    
             #IIII#    
 #############IIII#    
##   ##     ##IIII#####
#  CC##  C P##IIII    #
#      CC C#  IIII#   #
#  C ## CC # #IIII#  ##
#  C ## C  # ## ###  # 
## ##### ###         # 
##   C  C ##### ###  # 
# C###  # ##### # #### 
#   C   #       #      
#  C #C C C###  #      
# CCC# C   # ####      
#    #  CC #           
######   ###           
     #####             
