15
17
20
     #######   
     #P #  #   
     # C   #   
    ### ## #   
 #### C  # ##  
 #       #  ## 
 # C C#### C # 
 # CC #  #  C# 
 #C  C   #C  # 
##  CC#   CC ##
# CC  #  #  C #
#     #### C  #
#  #C##II##   #
### I#IIII#####
  # IIIIIII##  
  #IIII   II#  
  ###########  
