18
16
18
       #######    
 #######     #    
 #     # CPC #    
 #CC #   #########
 # ###IIIIII##   #
 #   CIIIIII## # #
 # ###IIIIII     #
##   #### ### #C##
#  #C   #  C  # # 
#  C CCC  # C## # 
#   C C ###CC # # 
#####     C   # # 
    ### ###   # # 
      #     #   # 
      ########  # 
             #### 
