20
13
18
    #########       
  ###   ##  #####   
###      #  #   ####
#  CC #C #  #  III #
# #  C#PC## # #I#I #
#  ## #C  #    III #
# C#    C # # #I#I #
#    ##  ##C C III #
# C ##   #  #C#I#I #
## CC  C   C  CIII #
 #C  ######    ##  #
 #   #    ##########
 #####              
