18
16
20
  ####            
  #  #########    
 ##  ## P#   #    
 #  C# C C   #### 
 #C  C  # C C#  ##
##  C## #C C     #
#  #  # #   CCC  #
# C    C  C## ####
# C C #C#  #  #   
##  ###  ###C #   
 #  #IIII     #   
 ####IIIIII####   
   #IIII####      
   #III##         
   #III#          
   #####          
