14
16
14
##########    
#        #### 
# ###### #  ##
# # C C C  C #
#       #C   #
###C  CC#  ###
  #  ## # C## 
  ##C#   C P# 
   #  C C ### 
   # #   C  # 
   # ##   # # 
  ##  ##### # 
  #         # 
  #IIIIIII### 
  #IIIIIII#   
  #########   
