14
15
15
#####         
#   ##        
#    #  ####  
# C  ####  #  
#  CC C   C#  
###P #C    ## 
 #  ##  C C ##
 # C  ## ## I#
 #  #C##C  #I#
 ###   CII##I#
  #    #IBIII#
  # CC #IIIII#
  #  #########
  #  #        
  ####        
