16
14
17
##### ####      
#III# #  ####   
#III###  C  #   
#IIII## C  C### 
##IIII##   C  # 
###III ## C C # 
# ##    #  C  # 
#  ## # ### ####
# C # #C  C    #
#  C P C    C  #
#   # C CC C ###
#  ######  ###  
# ##    ####    
###             
