13
12
11
       ##### 
 #######   ##
## # P## CC #
#    C      #
#  C  ###   #
### #####C###
# C  ### II# 
# C C C III# 
#    ###III# 
# CC # #III# 
#  ### ##### 
####         
