15
12
13
 #######       
 #  #  #####   
##  #  #III### 
#  C#  #III  # 
# C #CC III  # 
#  C#  #III I# 
#   # C########
##C       C C #
##  #  CC #   #
 ######  ##CCP#
      #      ##
      ######## 
