16
17
18
  ####          
  #  ###########
  #    C   C C #
  # C# C #  C  #
  #  C C  #    #
### C# #  #### #
#P#C C C  ##   #
#    C #C#   # #
##  C    C C C #
 ####  #########
  ###  ###      
  #      #      
  #      #      
  #IIIIII#      
  #IIIIII#      
  #IIIIII#      
  ########      
