13
18
24
 ########    
 #P##   #### 
 # C   C   # 
 #  C C CCC# 
 # CC# #   # 
##C    C   # 
#  C  CCCCC##
# C#### #   #
#  CIIII#   #
# ##IIII#CC #
# ##IIII   ##
#   IIII#  # 
## #IIII#CC# 
 # #IIII#  # 
 #         # 
 #### ##C### 
    #    #   
    ######   
