26
16
27
        #####             
        #   ####          
        # C    ####  #### 
        #   # C#  ####  # 
########### #   C   #   # 
#II     # C  #### #  #  # 
#IIC  #   C  #  C # C I## 
#IB# # C C ##  ##    #I#  
#II#C P #   ##    CC #I#  
#II# C C  C C ##   ## I#  
#IBCC # ##   C #C# C #I#  
#II#      ##   #     #I#  
#II#######  ### ######I## 
# CC                  BI##
#  ##################  II#
####                ######
