20
16
17
############  ######
#   #    #P####IIII#
#   CC#       IIIII#
#   # ###   ## IIII#
## ## ###  #   IIII#
 # C C     # ## ####
 #  C C##  #       #
#### #  #### ## ## #
#  # #C   ## ##    #
# C  C  # ## #######
# # C C    # #      
#  C ## ## # #      
# CC     CC  #      
## ## ### C  #      
 #    # #    #      
 ###### ######      
