22
17
19
    #########  ####   
    #   ##  ####  #   
    #   C   #  C  #   
    #  # ## #     ####
    ## C   C CC# #   #
    ####  #  # C C   #
#####  ####    ###III#
#   #C #  # ####IIIII#
#      #  # # ##IIIII#
###### #  #C   ###III#
   #   ## # C#   #III#
  ##       C  C# #####
 ## CCC##  # C   #    
 #   #  # ###  ###    
 #   C  #C P####      
 #####  #   #         
     ########         
