21
19
23
   ##########        
   #IIIIIIII####     
   #I#I#IIII#  #     
   #IIIIIIIICC #     
   #     I###  ####  
 #########  C #   #  
 #     C   C C  C #  
 #  #    #  C C#  #  
 ## #####   #  #  #  
 # C     #   #### #  
##  C#   # ##  #  #  
#    ##C###    #  ## 
# C    C #  #  #   # 
#####    # ## # ## ##
    #C# #  C  C C   #
    #P#  C#CCC  #   #
    ###  C      #####
      ##  #  #  #    
       ##########    
