21
15
20
###########          
#IIIIII   #########  
#IIIIII   #  ##   #  
#II### C    C     #  
#III C C #  ###   #  
#III#C#####    #  #  
###    #   #C  # C###
  #  CC C C  C##  C #
  #  C   #C#  ##    #
  ### ## #  C #######
   #  C C ## ##      
   #    C  C  #      
   ##   # #   #      
    #####P#####      
        ###          
