20
20
29
       ############ 
       #IIIIIIIIII# 
     ###I#I#I#I#II# 
     #   IIIIIIIII# 
     #P C C C BIBI# 
    ####### ####### 
 ####   #    ##  #  
##    C #    # C ## 
#  #C# ### ###C   ##
# C  C C   # C C C #
#  # C ##       #C #
#   C####C####C##  #
####  ##   #    #  #
   #C ##   # # CC  #
   #   # C #  C    #
   ### # CC #  C ###
     # #    # C ##  
     # ######## #   
     #          #   
     ############   
