14
20
18
 #####        
 #   #######  
 # C ###   #  
 # C    CC #  
 ## ####   #  
### #  # ###  
#   #  #P##   
# CC    C #   
#   # # C ####
##### #   #  #
 #   C####   #
 #  C     C  #
 ##   ##### ##
 ##########  #
##IIII# C  C #
#IIIII# CC#  #
#II II# C  C #
#IIIIIC   #  #
##  ##########
 ####         
