15
15
13
#########      
#       #      
#       ####   
## #### #  #   
## #P##    #   
# CCC C  CC#   
#  # ## C  #   
#  # ##  C ####
####  CCC C#  #
 #   ##   IIII#
 # #   # #II I#
 #   # # ##III#
 ##### C  #III#
     ##   #####
      #####    
