23
17
21
               ####    
          ######  #####
    #######       #   #
    #      C C ## # # #
    #  #### C  #     I#
    #      C # # ##I#I#
    ##C####C C C ##I#I#
    #     #    ####I###
    # C   ######  #I#I#
######CCC##      P#I#I#
#      #    #C#C###I I#
# #### #CCCCC    # III#
# #    C     #   # III#
# #   ## ##     ###III#
# ######C######  ######
#        #    #  #     
##########    ####     
