19
16
16
      ############ 
     ##II    #   # 
    ##IIB C    C # 
   ##IIBI# # #C ## 
   #IIBI# # # C  # 
####III#  #    # # 
#  ## #          # 
# PC C ###  # # ## 
# C   C   # #   #  
###CC   # # # # #  
  #   C   # # #####
  # C# #####      #
  #C   #   #   #  #
  #  ###   ##     #
  #  #      #    ##
  ####      ###### 
